
7,6,6,6,6,6,6,6,4,0,0,6,6,0,7,6,6,6,6,6,6,6,4,0,0,0,0,0,0,0,0,0,0,0,0,0,0,7,6,6,6,4,0,0,0,0,0,0,0,0,0,0,7,6,6,6,6,6,6,6,4,0,0,6,0,0,0,7,6,6,6,6,6,6,6,6,6,6,6,6,4,0,0,6,0,0,7,6,6,6,6,6,6,6,6,6,6,6,6,4,
9,8,8,8,8,8,8,8,5,0,0,0,0,0,1,8,8,8,8,8,8,8,8,6,4,0,0,0,0,0,0,0,0,7,6,6,6,8,8,8,8,8,4,0,0,0,0,0,0,0,7,6,8,8,8,8,8,8,2,2,3,0,0,0,0,0,7,8,8,8,8,8,8,8,8,8,8,8,8,8,3,0,0,0,0,0,9,8,8,8,8,8,8,8,8,8,8,8,8,5,
9,8,8,8,8,8,8,8,8,4,0,0,0,0,0,9,8,8,8,8,8,8,8,8,8,4,0,0,0,0,0,0,7,8,8,8,8,8,8,8,8,8,8,4,0,0,0,0,0,7,8,8,8,8,8,8,8,3,0,0,0,0,0,0,0,7,8,8,8,8,8,8,8,8,8,8,8,8,8,5,0,0,0,0,0,7,8,8,8,8,8,8,8,8,8,8,8,8,8,5,
9,8,8,8,8,8,8,8,8,8,4,0,0,0,0,9,8,8,8,8,8,8,8,8,8,8,4,0,0,0,7,6,8,8,8,8,8,8,8,8,8,8,8,8,4,0,0,0,7,8,8,8,8,8,8,8,3,0,0,0,0,0,0,0,7,8,8,8,8,8,8,8,8,8,8,8,8,8,8,3,0,0,0,0,7,8,8,8,8,8,8,8,8,8,8,8,8,8,8,5,
9,8,8,8,8,8,8,8,8,8,5,0,0,0,0,1,8,8,8,8,8,8,8,8,8,8,8,6,6,6,8,8,8,8,8,8,8,8,8,8,8,8,8,8,8,6,6,6,8,8,8,8,8,8,8,5,0,0,0,0,0,0,7,6,8,8,8,8,8,8,8,8,8,8,8,8,8,8,3,0,0,0,0,7,8,8,8,8,8,8,8,8,8,8,8,8,8,8,8,5,
9,8,8,8,8,8,8,8,8,8,8,4,0,0,0,0,1,8,8,8,8,8,8,8,8,8,8,8,8,8,8,8,8,8,8,8,8,8,8,8,8,8,8,8,8,8,8,8,8,8,8,8,8,8,8,3,0,0,0,0,0,0,9,8,8,8,8,8,8,8,8,8,8,8,8,8,8,5,0,0,0,0,0,9,8,8,8,8,8,8,8,8,8,8,8,8,8,8,8,5,
9,8,8,8,8,8,8,8,8,8,8,5,0,0,0,0,0,1,8,8,8,8,8,8,8,8,8,8,8,8,8,8,8,8,8,8,8,8,8,8,8,8,8,8,8,8,8,8,8,8,8,8,8,2,3,0,0,0,0,0,0,7,8,8,8,8,8,8,8,8,8,8,8,8,8,8,8,3,0,0,0,0,7,8,8,8,8,8,8,8,8,8,8,8,8,8,8,8,8,5,
9,8,8,8,8,8,8,8,8,8,8,8,4,0,0,0,0,0,1,8,8,8,8,8,8,8,8,8,8,8,8,8,8,8,8,8,8,8,8,8,8,8,8,8,8,8,8,8,8,8,8,2,3,0,0,0,0,0,0,0,7,8,8,8,8,8,8,8,8,8,8,8,8,8,8,8,3,0,0,0,0,7,8,8,8,8,8,8,8,8,8,8,8,8,8,8,8,8,8,5,
9,8,8,8,8,8,8,8,8,8,8,8,5,0,0,0,0,0,0,1,2,2,2,8,8,8,8,8,8,8,8,8,8,8,8,8,8,8,8,8,8,8,8,8,8,8,8,8,8,8,3,0,0,0,0,0,0,0,0,7,8,8,8,8,8,8,8,8,8,8,8,8,8,8,8,3,0,0,0,0,0,9,8,8,8,8,8,8,8,8,8,8,8,8,8,8,8,8,8,5,
9,8,8,8,8,8,8,8,8,8,8,8,8,4,0,0,0,0,0,0,0,0,0,1,2,2,2,2,2,2,2,2,2,2,2,8,8,8,8,8,2,2,2,2,2,2,2,2,2,3,0,0,0,0,0,0,7,6,6,2,2,2,2,2,2,8,8,8,8,2,2,2,2,2,3,0,0,0,0,0,7,8,8,8,8,8,8,8,8,8,8,8,8,8,8,8,8,8,8,5,
9,8,8,8,8,8,8,8,8,8,8,8,8,5,0,0,0,0,0,0,0,0,0,0,0,0,0,0,0,0,0,0,0,0,0,1,2,2,2,3,0,0,0,0,0,0,0,0,0,0,0,0,0,0,0,0,1,2,3,0,0,0,0,0,0,1,2,2,3,0,0,0,0,0,0,0,0,0,0,7,8,8,8,8,8,8,8,8,8,8,8,8,8,8,8,8,8,8,8,5,
9,8,8,8,8,8,8,8,8,8,8,8,8,8,4,0,0,0,0,0,0,0,0,0,0,0,0,0,0,0,0,0,0,0,0,0,0,0,0,0,0,0,0,0,0,0,0,0,0,0,0,0,0,0,0,0,0,0,0,0,0,0,0,0,0,0,0,0,0,0,0,0,0,0,0,0,0,0,7,8,8,8,8,8,8,8,8,8,8,8,8,8,8,8,8,8,8,8,8,5,
9,8,8,8,8,8,8,8,8,8,8,8,8,8,8,4,0,0,0,0,0,0,0,0,0,0,0,0,0,0,0,0,0,0,0,0,0,0,0,0,0,0,0,0,0,0,0,0,0,0,0,0,0,0,0,0,0,0,0,0,0,0,0,0,0,0,0,0,0,0,0,0,0,0,0,0,0,7,8,8,8,8,8,8,8,8,8,8,8,8,8,8,8,8,8,8,8,8,8,5,
9,8,8,8,8,8,8,8,8,8,8,8,8,8,8,8,4,0,0,0,0,0,0,0,0,0,0,0,0,0,0,0,0,0,0,0,0,0,0,0,0,0,0,0,0,0,0,0,0,0,0,0,0,0,0,0,0,0,0,0,0,0,0,0,0,0,0,0,0,0,0,0,0,0,0,0,7,8,8,8,8,8,8,8,8,8,8,8,8,8,8,8,8,8,8,8,8,8,8,5,
9,8,8,8,8,8,8,8,8,8,8,8,8,8,8,8,8,4,0,0,0,0,0,0,0,0,0,0,0,0,0,0,0,0,0,0,0,0,0,0,0,0,0,0,0,0,0,0,0,0,0,0,0,0,0,0,0,0,0,0,0,0,0,0,0,0,0,0,0,0,0,0,0,0,0,7,8,8,8,8,8,8,8,8,8,8,8,8,8,8,8,8,8,8,8,8,8,8,8,5,
9,8,8,8,8,8,8,8,8,8,8,8,8,8,8,8,8,8,6,4,0,0,0,0,0,0,7,6,4,0,0,0,0,0,7,6,6,6,4,0,0,0,0,0,0,0,0,0,0,0,0,0,0,0,0,0,0,0,0,0,0,0,0,0,0,0,0,0,0,0,0,0,0,0,7,8,8,8,8,8,8,8,8,8,8,8,8,8,8,8,8,8,8,8,8,8,8,8,8,5,
9,8,8,8,8,8,8,8,8,8,8,8,8,8,8,8,8,8,2,3,0,0,0,0,0,7,8,8,8,6,6,6,6,6,8,8,8,8,8,6,6,4,0,0,0,0,7,6,6,6,6,6,6,6,6,6,6,6,6,4,0,0,0,0,0,0,0,7,6,6,6,6,6,6,8,8,8,8,8,8,8,8,8,8,8,8,8,8,8,8,8,8,8,8,8,8,8,8,8,5,
9,8,8,8,8,8,8,8,8,8,8,8,8,8,8,8,2,3,0,0,0,0,0,0,7,8,8,8,8,8,8,8,8,8,8,8,8,8,8,8,2,3,0,0,0,0,9,8,8,8,8,8,8,8,8,8,8,8,8,8,4,0,0,0,0,0,0,1,2,8,8,8,8,8,8,8,8,8,8,8,8,8,8,8,8,8,8,8,8,8,8,8,8,8,8,8,8,8,8,5,
9,8,8,8,8,8,8,8,8,2,2,2,2,2,2,3,0,0,0,0,0,0,0,7,8,8,8,8,8,8,8,8,8,8,8,8,8,8,8,3,0,0,0,0,7,6,8,8,8,8,8,8,8,8,8,8,8,8,8,8,8,4,0,0,0,0,0,0,0,1,8,8,8,8,8,8,8,8,8,8,8,8,8,8,8,8,8,8,8,8,8,8,8,8,8,8,8,8,8,5,
9,8,8,8,8,8,8,2,3,0,0,0,0,0,0,0,0,0,0,0,0,7,6,8,8,8,8,8,8,8,8,8,8,8,8,8,8,2,3,0,0,0,0,7,8,8,8,8,8,8,8,8,8,8,8,8,8,8,8,8,8,8,6,4,0,0,0,0,0,0,1,8,8,8,8,8,8,8,8,8,8,8,8,8,8,8,8,8,8,8,8,8,8,8,8,8,8,8,8,5,
9,8,8,8,8,8,5,0,0,0,0,0,0,0,0,0,0,0,0,0,7,8,8,8,8,8,8,8,8,8,8,8,8,8,8,2,3,0,0,0,0,0,7,8,8,8,8,8,8,8,8,8,8,8,8,8,8,8,8,8,8,8,8,8,4,0,0,0,0,0,0,1,2,2,8,8,8,8,8,8,8,8,8,8,8,8,8,8,8,8,8,8,8,8,8,8,8,8,8,5,
9,8,8,8,8,8,5,0,0,0,0,0,0,0,0,0,0,0,0,7,8,8,8,8,8,8,8,8,8,8,8,8,8,2,3,0,0,0,0,0,0,0,9,8,8,8,8,8,8,8,8,8,8,8,8,8,8,8,8,8,8,8,8,8,8,4,0,0,0,0,0,0,0,0,1,8,8,8,8,8,8,8,8,8,8,8,8,8,8,8,8,8,8,8,8,8,8,8,8,5,
9,8,8,8,8,8,5,0,0,0,0,0,0,0,0,0,0,0,0,1,2,2,2,2,2,2,2,2,2,2,2,2,3,0,0,0,0,0,0,0,0,0,1,2,2,2,2,2,2,2,2,2,2,2,2,2,2,2,2,2,2,2,2,2,2,3,0,0,0,0,0,0,0,0,0,1,2,2,2,8,8,8,8,8,8,8,8,8,8,8,8,8,8,8,8,8,8,8,8,5,
9,8,8,8,8,8,5,0,0,0,0,0,0,0,0,0,0,0,0,0,0,0,0,0,0,0,0,0,0,0,0,0,0,0,0,0,0,0,0,0,0,0,0,0,0,0,0,0,0,0,0,0,0,0,0,0,0,0,0,0,0,0,0,0,0,0,0,0,0,0,0,0,0,0,0,0,0,0,0,1,2,2,2,2,2,2,2,2,2,8,8,8,8,8,8,8,8,8,8,5,
9,8,8,8,8,8,5,0,0,0,0,0,0,0,0,0,0,0,0,0,0,0,0,0,0,0,0,0,0,0,0,0,0,0,0,0,0,0,0,0,0,0,0,0,0,0,0,0,0,0,0,0,0,0,0,0,0,0,0,0,0,0,0,0,0,0,0,0,0,0,0,0,0,0,0,0,0,0,0,0,0,0,0,0,0,0,0,0,0,1,2,2,8,8,8,8,8,8,8,5,
9,8,8,8,8,8,5,0,0,0,0,0,7,6,6,6,6,6,6,6,6,0,0,0,0,0,0,0,0,0,0,0,0,0,0,0,0,0,0,0,0,0,0,0,0,0,0,0,0,0,0,0,0,0,0,0,0,0,0,0,0,0,0,0,0,0,0,0,0,0,0,0,0,0,0,0,0,0,0,0,0,0,0,0,0,0,0,0,0,0,0,0,9,8,8,8,8,8,8,5,
9,8,8,8,8,8,8,6,6,6,6,6,8,8,8,8,8,8,8,8,8,6,6,6,6,6,6,6,6,0,0,0,0,0,0,0,0,0,0,0,0,0,0,0,0,0,0,0,0,0,0,0,0,0,0,0,0,0,0,0,0,0,0,0,0,0,0,0,0,0,0,7,4,0,0,0,0,0,0,0,0,0,0,0,0,0,0,0,0,0,0,0,9,8,8,8,8,8,8,5,
9,8,8,8,8,8,8,8,8,8,8,8,8,8,8,8,8,8,8,8,8,8,8,8,8,8,8,8,8,6,0,0,0,0,7,6,6,6,6,6,6,0,0,0,0,0,0,0,0,0,0,0,0,0,0,0,0,0,0,0,0,0,0,0,0,0,0,0,0,0,0,9,8,4,0,0,0,0,0,0,0,0,0,0,0,0,0,0,0,0,7,6,8,8,8,8,8,8,8,5,
9,8,8,8,8,8,8,8,8,8,8,8,8,8,8,8,8,8,8,8,8,8,8,8,8,8,8,8,8,8,6,6,6,6,8,8,8,8,8,8,8,6,6,6,6,6,6,6,6,6,6,6,6,6,6,6,6,6,6,6,6,6,6,6,6,6,6,6,6,6,6,8,8,8,6,6,6,6,6,6,6,6,6,6,6,6,6,6,6,6,8,8,8,8,8,8,8,8,8,5,
1,8,8,8,8,8,8,8,8,8,8,8,8,8,8,8,8,8,8,8,8,8,8,8,8,8,8,8,8,8,8,8,8,8,8,8,8,8,8,8,8,8,8,8,8,8,8,8,8,8,8,8,8,8,8,8,8,8,8,8,8,8,8,8,8,8,8,8,8,8,8,8,8,8,8,8,8,8,8,8,8,8,8,8,8,8,8,8,8,8,8,8,8,8,8,8,8,8,8,3

